###############
@     #  #     
#  ## # ## #  #
# #  ##    ####
#    # # ### ##
#  # # #   #   
# ## #  ##   # 
# ##  #  ### # 
#   #  #    #  
###  # ### ## #
#  # # # #    #
## # ##  ### ##
#       ##   ##
# # # #    #  .
###############